111111111111111111
1PB0000000000B0001
10B0B00B0BBBBB0B01
10B0B0B00CBBCB0B01
1000B0CB0BCB0BCB01
1CB0CBBB00000C0BE1
111111111111111111
