111111111111111111
1111110B111C1110C1
1111110C1110C11011
1110C00B0BC0110CB1
1110P10000000B0011
1C0B01C00011C00111
1100C1110111100011
111C1111C1111EBC11
111111111111111111
