1111111111111111111
1111110B11111111111
1111110C11111111111
1110C00B0BC0110C111
1110P00B00000B00111
1C0001C00011C000111
1110C11111111000111
11111111111110BC111
1111111111111E11111
1111111111111111111
