1111111111111111111111111111
11110001CCCC11111111011C0C11
1CCC0111100111000000011C1011
111101110011110C111100000B11
1C0B0001B000000B011110101011
1100010101111P10110100B11011
111111010000C110110110000C11
1C1110C0010110001100001010C1
1C11111101111111111111100011
101C00000CCCCCC001101B001011
10111111B011110B00000C011001
1011111100001001111001011111
100C010001101100000011011111
1111000B1C0010010111000000E1
1C1101001111101011C001011111
1000011C111000001111C1C11111
1111111111111111111111111111
