11111111111111111111
1CCCC11C11C1C100C1C1
1111C110110101010101
1C11C0000P00000BCCC1
1CCCC110111111111111
11111110CB111C1C1BC1
10C10000B00000000001
1100C110C01C1C11BBE1
11111111111111111111
