1111111111111111111
10C000000000C0001P1
1000000C00000000101
100000000000E000111
1C0000C000000000001
1111111111111111111
