111111111111111
1000000000001C1
100000000000111
1000P0000C00001
1000000E0000001
111111111111111
