1111111
1110E11
10P0011
100E001
11100C1
1111111
