111111111
1000X0001
1C00E00P1
100000001
111111111
