1111111111111111111
1111110011111111111
1111110C11111111111
1110C00B00C0110C011
1000P00BB0000B00011
1C0001C00010C000011
1110C11111111000011
111111111111100C111
1111111111111E11111
1111111111111111111
