1111111111111111111
1111110011111111111
1111110C11111111111
1000C00B00C0110C001
1000P00BB0000B00001
1C0000C00010C000001
1000C11111100000001
111111111111100C111
1111111111111E11111
1111111111111111111
