1111111
1111111
10P0001
100E001
10000C1
1111111
