1111111
1111111
10P0011
100E001
11100C1
1111111
