1111111111111111111111111111
1000000100001100001000101001
1001000110001100001001010001
111100010111000C110000000111
1000000100000000011110101011
1111110001111P10100100011011
1100010000010110100110000011
1000100001011001010000101001
1001101000000100010010000011
1000101000000000001011100011
100110100011110011000C011001
1000000000001001110001000111
1000001011100100000110000001
100000001100100101000000E001
101100010111101011C001000001
1000001011100000110000000001
1111111111111111111111111111
