1111111111111111111111111111
11110001000011111110001010C1
100C011110001100001001010001
111100010111000C110000000111
10000C0100000000011110101011
1111110001111P10100100011011
1100010000010110100110000C11
100010C001011001010000101001
100111110000010011111000C011
100010100CCCCCC0001011000011
100110100011110010000C011001
1000000000001001110001000111
100C001011100100000110000111
111100001100100101000000E001
1C1100010111101011C001000001
1000001011100000110000011111
1111111111111111111111111111
