1111111111111111111111111111
11110001CCCC11111111011C1C11
1CCC0111100111000000011C1011
111101110011110C111100000011
1C00000100000000011110101011
1111110101111P10100100011011
111111010000C110100110000C11
1C1110C0010110010100001010C1
1C11111101111111111111100011
101C00000CCCCCC0011011001011
101111110011110010000C011001
1011111100001001111001011111
100C011001101100000011011111
111100001C0010010111000000E1
1C1101101111101011C001011111
1000011C111000001111C1C11111
1111111111111111111111111111
