1111011111111111111
1111110011111111111
0111110C11111111111
1000C00B00C0000C001
1000P00BB0000B00001
1C0000C00000C000001
1000C11111100000001
111111111111100C111
111111111E111111110
1111111101111111111
