1111111
1110E11
10P0011
100E001
1110001
1111111
