11111111
1000C001
1P000001
11111111
