11111111
1000C001
1E000001
11111111
